xxxxxxxxxxxx
xxx      xxx
x
xx   xx    x
x          x
x   xx    x
x    xx   x
x       xx   
xxxxxxxxxxxx